npcname_JP.	”L‚©‚Ô‚èwƒ~[ƒAx
npcname_EN.	<Mia> the cat freak
numflavor_passiveJP.	7
numflavor_passiveEN.	8
flavorpassive_JP.0	u‚é‚ñ‚é‚ñ‚é‚ñôv
flavorpassive_JP.1	u‚¤‚İ‚İ‚áHv
flavorpassive_JP.2	u‚É‚µ‚µIv
flavorpassive_JP.3	u‚Ó`‚ñ‚Ó`‚ñ‚Ó`‚ñô1v
flavorpassive_JP.4	u‚«‚Ì‚±‚Ì‚±‚Ì‚±‚°‚ñ‚«‚Ì‚±‚§`ô v
flavorpassive_JP.5	u‚¨[B‚¦‚è‚ñ‚¬‚Ü‚¢‚½‚¯‚Ô‚È‚µ‚ß‚¶‚¡`v
flavorpassive_JP.6	uƒt[ƒ“@ƒtƒ“ƒtƒ“@ƒt[ƒ“@ƒtƒ“ƒtƒ“@ƒlƒR‚Ìƒt`ƒ“ô@ƒt[ƒ“@ƒtƒ“ƒtƒ“@ƒt[ƒ“@ƒtƒ“ƒtƒ“@‚©‚½‚¢ôv
flavorpassive_EN.0	"I nyo talk funny, nyou talk funnyô"
flavorpassive_EN.1	"Nyah! Water! I hates it so."
flavorpassive_EN.2	"Pug!"
flavorpassive_EN.3	"Nyo touching! No Bump-Bump for nyou."
flavorpassive_EN.4	"ôNyobody knyows the touble Mia's seen, nyobody knyows Mia's Tru-bullô"
flavorpassive_EN.5	You hear the oddest voice in the crowd, it is lilting and...cat-like?
flavorpassive_EN.6	"ôMeow-meow meow-meow, meow-meow meow-meowô"
flavorpassive_EN.7	Sounds like a childish song about... mushrooms?
numflavor_angeredJP.	0
numflavor_angeredEN.	0
numflavor_deathJP.	1
numflavor_deathEN.	1
flavordeath_JP.0	u‚Í‚í‚íA‚«‚Á‚Æ—ˆ¢‚Í”L‚É¶‚Ü‚ê‚é‚ñ‚¾ƒ‚ƒ“v
flavordeath_JP.0	"Squee... I'll be reborn in the nyext world as a cat"
numflavor_killJP.	1
numflavor_killEN.	1
flavorkill_JP.0	uƒA[ƒ“AƒoƒJôv
flavorkill_EN.0	"Ahnyou idiotô"
numflavor_welcomeJP.	0
numflavor_welcomeEN.	0
