npcname_JP.	•”L
npcname_EN.	black cat
numflavor_passiveJP.	4
numflavor_passiveEN.	4
flavorpassive_JP.0	u‚¤‚İ‚İ‚áv
flavorpassive_JP.1	u‚İ‚ã[v
flavorpassive_JP.2	u‚İ‚áv
flavorpassive_JP.3	 *‚²‚ë‚²‚ë* 
flavorpassive_EN.0	"Mi mi"
flavorpassive_EN.1	"Meww"
flavorpassive_EN.2	"Mya"
flavorpassive_EN.3	 *purr* 
numflavor_angeredJP.	3
numflavor_angeredEN.	3
flavorangered_JP.0	uƒtƒVƒ…[ƒbv
flavorangered_JP.1	u‚¤‚İ‚İ‚áIv
flavorangered_JP.2	u‚İ‚áIv
flavorangered_EN.0	*fssss*
flavorangered_EN.1	"Mi mya!"
flavorangered_EN.2	"Mya!"
numflavor_deathJP.	1
numflavor_deathEN.	1
flavordeath_JP.0	u‚¤‚İc‚İ‚ácv
flavordeath_EN.0	"Hh... mya..."
numflavor_killJP.	1
numflavor_killEN.	1
flavorkill_JP.0	•”L‚ÍK”ö‚ğ‚Ó‚Á‚½B
flavorkill_EN.0	The black cat shakes its tail angrily
numflavor_welcomeJP.	1
numflavor_welcomeEN.	0
flavorwelcome_JP.0	u‚¨‚©‚¦‚è‚İ‚á[v
