npcname_JP.	ƒnƒ€‘å˜V
npcname_EN.	ham-tairou
numflavor_passiveJP.	3
numflavor_passiveEN.	0
flavorpassive_JP.0	u‚Ö‚¯‚Áv
flavorpassive_JP.1	u‚­‚µ‚­‚µv
flavorpassive_JP.2	u‚Ä‚¿‚Ä‚¿v
flavorpassive_EN.0	ô1
flavorpassive_EN.1	"Kushi-kushi"
flavorpassive_EN.2	"Ticky-ticky"
numflavor_angeredJP.	0
numflavor_angeredEN.	0
numflavor_deathJP.	1
numflavor_deathEN.	0
flavordeath_JP.0	u‚Ö‚ë[‚ñv
flavordeath_EN.0	"Hello"
numflavor_killJP.	2
numflavor_killEN.	0
flavorkill_JP.0	u‚©‚¶‚©‚¶v
flavorkill_JP.1	u‚à‚Ğ‚à‚Ğv
numflavor_welcomeJP.	1
numflavor_welcomeEN.	1
flavorwelcome_JP.0	u‚Í‚Ş‚Í[v
flavorwelcome_EN.0	"Ham-ha!"