npcname_JP.	ƒGƒ“ƒ^ƒƒCƒhEƒUƒ“ƒRƒbƒN
npcname_EN.	performaid cocruel
numflavor_passiveJP.	0
numflavor_passiveEN.	0
numflavor_angeredJP.	1
numflavor_angeredEN.	1
flavorangered_JP.0	u‚Æ‚Ñ‚«‚èc“‚É‚¢‚«‚Ü‚·‚æv
flavorangered_EN.0	"I will cruely show you only extreme cruelty"
numflavor_deathJP.	0
numflavor_deathEN.	0
numflavor_killJP.	1
numflavor_killEN.	1
flavorkill_JP.0	u‚ ‚­‚Ü‚ÅƒƒCƒh‚Å‚·‚©‚çv
flavorkill_EN.0	"You see I am simply one hell of a maid"
numflavor_welcomeJP.	2
numflavor_welcomeEN.	2
flavorwelcome_JP.0	u‚¨‚©‚¦‚è‚È‚³‚¢‚Ü‚¹A%syujin%cv
flavorwelcome_JP.1	u‚Ó‚Óc‘Ş‹ü‚Å‚Í‚ ‚è‚Ü‚¹‚ñ‚Å‚µ‚½‚©Hv
flavorwelcome_EN.0	"Welcome home, %syujin%"
flavorwelcome_EN.1	"Hehe... was it not boring?"
