npcname_JP.	ƒƒCƒh
npcname_EN.	maid
numflavor_passiveJP.	4
numflavor_passiveEN.	5
flavorpassive_JP.0	u%syujin%`v
flavorpassive_JP.1	%syujin%`
flavorpassive_JP.2	u—p–‚Í‚ ‚è‚Ü‚¹‚ñ‚©ôv
flavorpassive_JP.3	ƒƒCƒh‚Ì”M‚¢‹ü‚ğŠ´‚¶‚éc
flavorpassive_EN.0	"M-%syujin%~"
flavorpassive_EN.1	"Oh %syujin%, I don't do THOSE sorts of thingsô..."
flavorpassive_EN.2	The maid looks good enough to touch
flavorpassive_EN.3	You feel a burning sensation. You discover the maid is gazing at you.
flavorpassive_EN.4	"Do you have any errands for me?"
numflavor_angeredJP.	2
numflavor_angeredEN.	2
flavorangered_JP.0	u‚¨‚¢‚½‚ª‰ß‚¬‚Ü‚·‚æIv
flavorangered_JP.1	u‚¨d’u‚«‚Å‚·Iv
flavorangered_EN.0	"That's too far for a prank!"
flavorangered_EN.1	"You need to be punished!"
numflavor_deathJP.	2
numflavor_deathEN.	2
flavordeath_JP.0	uƒ_ƒ‚¥Iv
flavordeath_JP.1	u%syujin%[Iv
flavordeath_EN.0	"Noo!"
flavordeath_EN.1	"%syujin%!"
numflavor_killJP.	0
numflavor_killEN.	0
numflavor_welcomeJP.	2
numflavor_welcomeEN.	2
flavorwelcome_JP.0	u‚¨‚©‚¦‚è‚È‚³‚¢‚Ü‚¹A%syujin%`v
flavorwelcome_JP.1	u‚¨‚©‚¦‚è‚È‚³‚¢‚Ü‚µ`v
flavorwelcome_EN.0	"Welcome home, %syujin%~"
flavorwelcome_EN.0	"Welcome baack~"

