npcname_JP.	姉犬
npcname_EN.	older dog sister
numflavor_passiveJP.	3
numflavor_passiveEN.	2
flavorpassive_JP.0	「この服似合う？似合う？」
flavorpassive_JP.1	「わんわんっ！」
flavorpassive_JP.2	「もっとかまってほしいわん…」
flavorpassive_EN.0	"Wuf wuff"
flavorpassive_EN.1	"I want to cuddle and play fetch more"
numflavor_angeredJP.	4
numflavor_angeredEN.	4
flavorangered_JP.0	「お姉ちゃんに任せるわん！」
flavorangered_JP.1	「わふっ」
flavorangered_JP.2	「わおーん」
flavorangered_JP.3	「うー！がるるるー！」
flavorangered_EN.0	"Leave yip to your older sister!" 
flavorangered_EN.1	"Bark"
flavorangered_EN.2	"Bow wow"
flavorangered_EN.3	"Grr! *Growl!*"
numflavor_deathJP.	3
numflavor_deathEN.	3
flavordeath_JP.0	「きゅーん…」
flavordeath_JP.1	「お姉ちゃんはもうだめだわん」
flavordeath_JP.2	「きゃうん！」
flavordeath_EN.0	The older sister's body clenches in frustration.
flavordeath_EN.1	"Look, I arfailed as your older sister"
flavordeath_EN.2	"Ruff!"
numflavor_killJP.	3
numflavor_killEN.	3
flavorkill_JP.0	姉は興奮してちぎれんばかりに尻尾を振った。
flavorkill_JP.1	「やっつけたよ！褒めて褒めてー♪」
flavorkill_JP.2	「わんわん♪次の相手は誰だー！」
flavorkill_EN.0	The older sister wagged so excitedly the tail fell asleep.
flavorkill_EN.1	"I destroyed it! Praise me, praise me ♪"
flavorkill_EN.2	"Arf arf ♪ Who's the next enemy?"
numflavor_welcomeJP.	3
numflavor_welcomeEN.	3
flavorwelcome_JP.0	「おかえりわん」
flavorwelcome_JP.1	「帰ってきたの？帰ってきたの？遊ぼ！」
flavorwelcome_JP.2	「お散歩行こうよ！お散歩！」
flavorwelcome_EN.0	"Woofcome home!"
flavorwelcome_EN.1	"You're home? You're back? Let's play!"
flavorwelcome_EN.2	"Let's go for a walk! Walk!"