npcname_JP.	黒お嬢様
npcname_EN.	white young lady
numflavor_passiveJP.	3
numflavor_passiveEN.	3
flavorpassive_JP.0	「退屈ですわ。何か芸をなさい」
flavorpassive_JP.1	「薄汚れた空気ですこと」
flavorpassive_JP.2	「なんと品のない…」
flavorpassive_EN.0	"I am bored. Do some kind of clever trick, will you?"
flavorpassive_EN.1	"Things are simply dreary."
flavorpassive_EN.2	"How boorish..."
numflavor_angeredJP.	3
numflavor_angeredEN.	3
flavorangered_JP.0	「まぁ！なんて目障りなのでしょう！」
flavorangered_JP.1	「あらあら、小汚い」
flavorangered_JP.2	「今、楽にして差し上げますわ」
flavorangered_EN.0	"My, what an eyesore you are! Oh, well."
flavorangered_EN.1	"Oh no, it's a dirty little fellow"
flavorangered_EN.2	"I'll make it easy for you and put you out of your misery."
numflavor_deathJP.	2
numflavor_deathEN.	2
flavordeath_JP.0	「あなたにはわたくしを守る義務がありましてよ？」
flavordeath_JP.1	「失望しましたわ」
flavordeath_EN.0	"Did you not have an obligation to protect me?"
flavordeath_EN.1	"I was very disappointed in you."
numflavor_killJP.	3
numflavor_killEN.	3
flavorkill_JP.0	「お洋服が汚れてしまいましたわ」
flavorkill_JP.1	「そんなものですの？」
flavorkill_JP.2	嬢は冷たく微笑みながら敵にトドメを刺した。
flavorkill_JP.0	"Look at what you've done, you've dirtied my dress!"
flavorkill_JP.1	"Is that it? Is this all you've got?"
flavorkill_JP.2	The young lady smiles coldly and she stabs the enemy with a finishing blow.
numflavor_welcomeJP.	2
numflavor_welcomeEN.	2
flavorwelcome_JP.0	「もちろん、手土産のひとつくらいあるのでしょうね？」
flavorwelcome_JP.1	「次はわたくしも連れてゆきなさい」
flavorwelcome_EN.0	"Of course, you only remembered one souvenir again, right?"
flavorwelcome_EN.1	"Take me along with you next time."



