npcname_JP.	弟狐
npcname_EN.	fox brother
numflavor_passiveJP.	6
numflavor_passiveEN.	6
flavorpassive_JP.0	「%onii%ちゃんっ」
flavorpassive_JP.1	「%onii%ちゃ…なんでもない」
flavorpassive_JP.2	「%onii%ちゃん♪1」
flavorpassive_JP.3	弟は寂しそうな声を出している。
flavorpassive_JP.4	「%onii%ちゃん？」
flavorpassive_JP.5	「こーん」
flavorpassive_EN.0	"%onii%..."
flavorpassive_EN.1	"%onii%... nothing"
flavorpassive_EN.2	"%onii% ♪"
flavorpassive_EN.3	The brother issues a lonely-sounding whine.
flavorpassive_EN.4	"%onii%?"
flavorpassive_EN.4	*kon*
numflavor_angeredJP.	0
numflavor_angeredEN.	0
numflavor_deathJP.	3
numflavor_deathEN.	3
flavordeath_JP.0	「あう…」
flavordeath_JP.1	「%onii%ちゃんどこにいるの…？何も見えないよ…」
flavordeath_JP.2	｢ぼく…しにたくない…よ…｣
flavordeath_EN.0	"Oh ..."
flavordeath_EN.1	"Where are you %onii%? ... I can't see anything ..."
flavordeath_EN.2	"I... don't wanna... die"
numflavor_killJP.	4
numflavor_killEN.	4
flavorkill_JP.0	あなたは弟の姿に感心した。
flavorkill_JP.1	弟はおどおどしながらあなたの顔を覗いた。
flavorkill_JP.2	「こ、ころしたよー…」
flavorkill_JP.3	弟は嬉しそうにしっぽを振っている。
flavorkill_EN.0	You were impressed by the brother's presentation.
flavorkill_EN.1	The brother glances into your face nervously.
flavorkill_EN.2	"I really k-killed it..."
flavorkill_EN.3	The brother is wagging his tail happily.
numflavor_welcomeJP.	3
numflavor_welcomeEN.	2
flavorwelcome_JP.0	「おかえり、%onii%ちゃん」
flavorwelcome_JP.1	「寂しかったよ、%onii%ちゃん…」
flavorwelcome_JP.2	｢ぼくいい子にしてたよ！｣
flavorwelcome_EN.0	"Welcome home, %onii%"
flavorwelcome_EN.1	"I missed you, %onii%..."
flavorwelcome_EN.2	"I've been a good boy!"
