npcname_JP.	ƒWƒ…[ƒAŠO–@‹­‰»•º
npcname_EN.	juere demon soldier
numflavor_passiveJP.	0
numflavor_passiveEN.	0
numflavor_angeredJP.	4
numflavor_angeredEN.	4
flavorangered_JP.0	u‚¢‚¢‹C•ª‚¾c‚Æ‚Ä‚àcv
flavorangered_JP.1	uƒNƒNƒNcv
flavorangered_JP.2	u‚³‚ŸA‚Ç‚ñ‚È€‚É•û‚ğ‚µ‚½‚¢Hv
flavorangered_JP.3	u‚Ğ‚ĞA‚Ğ‚Ğ‚Ğ‚Ğ‚ĞIv
flavorangered_EN.0	"That feels... I feel really great. So good..."
flavorangered_EN.1	"Kyahahahaha!"
flavorangered_EN.2	"Now, what kind of death would you like?"
flavorangered_EN.3	"Hee hee, heheheheheh!"
numflavor_deathJP.	3
numflavor_deathEN.	0
flavordeath_JP.0	u”n­‚ÈI”n­‚È‚Ÿ‚Ÿ‚Ÿ‚Ÿ‚ÁIIv
flavordeath_JP.1	u‚®‚¬‚¬‚¬‚¡Iv
flavordeath_JP.2	u‚à‚Á‚Æc—Í‚ğ‚ÁIv
flavordeath_EN.0	"Foolish! Uselessss!!"
flavordeath_EN.1	"Guh, ugggh"
flavordeath_EN.2	"More... power! "
numflavor_killJP.	2
numflavor_killEN.	2
flavorkill_JP.0	u—Í‚¾cI‚±‚ê‚ª—Í‚¾Iv
flavorkill_JP.1	u‚Í‚Ÿ[‚ÁA‚Í‚Ÿ[‚ÁI‚Óc‚Í‚Í‚Í‚Í‚ÍIv
flavorkill_EN.0	"It's power ... this is power!"
flavorkill_EN.1	"Hah, haha! Wahahahahaha!"
numflavor_welcomeJP.	0
numflavor_welcomeEN.	0
