npcname_JP.	探偵
npcname_EN.	detective
numflavor_passiveJP.	0
numflavor_passiveEN.	0
numflavor_angeredJP.	3
numflavor_angeredEN.	3
flavorangered_JP.0	「自分の罪を数えてろ」
flavorangered_JP.1	「探偵の名にかけて！」
flavorangered_JP.2	「灰色の脳細胞を使う時だ！」
flavorangered_EN.0	"Let us exercise our little grey cells"
flavorangered_EN.1	"In the name of the Detective!"
flavorangered_EN.2	"There's always only one truth, and one truth prevails!"
numflavor_deathJP.	2
numflavor_deathEN.	2
flavordeath_JP.0	「真実はいつだってひとつ！」
flavordeath_JP.1	「死ぬことは、少しさよならすることだ」
flavordeath_EN.0	You hear a masked Bogart accent: "Count your sins" 
flavordeath_EN.1	The detective tosses a bullet. "To say a long goodbye is to die a little."
numflavor_killJP.	2
numflavor_killEN.	2
flavorkill_JP.0	「誰がこんなひどいことを…」
flavorkill_JP.1	「Q. E. D. （証明終わり）」
flavorkill_EN.0	"Who would do such a terrible thing..."
flavorkill_EN.1	"Q. E. [D]. (Thus, it is demonstrated; the proof is completely done)"
numflavor_welcomeJP.	0
numflavor_welcomeEN.	0
