npcname_JP.	牛
npcname_EN.	cattle
numflavor_passiveJP.	2
numflavor_passiveEN.	2
flavorpassive_JP.0	「モウ」
flavorpassive_JP.1	「モォー」
flavorpassive_EN.0	"Moo."
flavorpassive_EN.1	"Moooo"
numflavor_angeredJP.	0
numflavor_angeredEN.	0
numflavor_deathJP.	1
numflavor_deathEN.	1
flavordeath_JP.0	「モーイヤ」
flavordeath_EN.0	"Mooyah"
numflavor_killJP.	1
numflavor_killEN.	1
flavorkill_JP.0	「ンモー」
flavorkill_EN.0	"Nmoo"
numflavor_welcomeJP.	0
numflavor_welcomeEN.	0
